


           1   2   3   4   5   
             _________________
            |                 |
            |                 |
            |                 |  
            |                 |
            |_______HHH_______|